################
#..............#
#....###.......#
#..............#
#..............#
#..............#
#..............#
#.......###....#
#.......#......#
#.......#......#
#.......#......#
#..............#
#..............#
#.#............#
#..............#
################