################################
#..................#.#.........#
#....###............#..........#
#..............................#
#..............................#
#.............................##
#..............................#
#.......###....................#
#.......#......................#
#.......#.................#.#..#
#.......#......................#
#.........................#.#..#
#..............................#
#.#............................#
#..............................#
#............#....#............#
#............#....#............#
#..............................#
#..............................#
#............######............#
#..............................#
#..............................#
#......#.#.#.#.................#
#..............................#
#......#.#.#.#.................#
#..............................#
#......#.#.#.#.................#
#.............................##
#......#.#.#.#...............#.#
#...........................#..#
#..........................#...#
################################